 11111111111111
10000000P000001
100000E00000001
100000000000001
1000000C0000001
100000000000001
111111111111111
