111111111111111111111111111111
1P0110000000001100000000011001
100110000110001100011000011001
100110000110001100011000011001
100110000110001100011000011001
10011C000110001100011C00011001
100111111110001100011111111001
100000000000111111000000000001
10011111111001EE10011111111001
10000000011001001001C000001001
100100000110010010011000001001
100100000110010010011000001001
10010000C110010010011000000001
100111111110010010011111111001
100110000000110011000000011001
100011000000110011000001100001
100001100001100001100001100001
10000011C011001100110C11C00001
100111111110001100011111111001
100000000000001100000000000001
111111111111111111111111111111
